111111111111111111
10010000000C1111
1000011111001111111
1P0011E00000111
1111111111111111