1111111111111111111111111111111111
1E0000000000000C00000C00F000000001
10100101001000001F1001000000010101
1010010010101010001001000F00010101
1P0000F00C00C0000F00000000000000C1
1111111111111111111111111111111111